peak - đỉnh cao
valuable - có giá trị lớn
associated - có liên quan
stuck - mắc kẹt
confuse - bối rối
avoid - tránh xa
tackle - giải quyết
separate - chia ra
rugby - bóng bầu dục
particular - cụ thể
pressure - áp lực
compulsory - bắt buộc
cognitive - nhận thức
perspectives - quan điểm
marure - trưởng thành
weird - kỳ quặc
maturity - sự trưởng thành
a lack of - sự thiếu hụt
minimal - tối thiểu
mystery - bí ẩn
bible - Kinh thánh
compensate - đền bù
bowel movement - đi tiêu
urine - nước tiểu
sweat - mồ hôi
surround - bao quanh
essentially - Thiết yếu
equivalent - tương đương
nourish - nuôi
composition - thành phần
