instant - lập tức
specifically - cụ thể
behavior - hành vi
gratification - sự thỏa mãn
extremely - vô cùng
starve - chết đói
reward - phần thưởng
admit - thừa nhận
uneasy - bồn chồn
vibrate - rung
Interactive - Tương tác
convenient - thuận lợi
effort - cố gắng
definitely - chắc chắn
urge - thúc giục
productive - có năng suất
reduce - giảm bớt
negative - tiêu cực
cause - nguyên nhân
triggers - kích hoạt
asset - tài sản
shape - hình dạng
wing - cánh
overwhelm - áp đảo
entire - toàn bộ
desserts - món tráng miệng
fusion - sự hợp nhất
proper - thích hợp
patient - kiên nhẫn
coworker - đồng nghiệp
deposits - tiền gửi
literally - theo đúng nghĩa đen
bald - hói
suspicious - khả nghi
pronounce - phát âm
preparing - chuẩn bị
produce - sản xuất
interacting - tương tác
cashier - thu ngân
ridiculous - lố bịch
anymore - nữa
shifts - ca làm việc
assume - cho rằng
split up - chia ra
anyway - Dẫu sao thì
apparent - rõ ràng
baskets - giỏ hàng
reuse - tái sử dụng
hire - thuê
fantastic - tuyệt vời
awesome - tuyệt vời
stuff for - đồ dùng cho
mostly - hầu hết
grocery store - cửa hàng tạp hóa
embarrassing - xấu hổ
motivation - động lực
peak - đỉnh cao
valuable - có giá trị lớn
associated - có liên quan
stuck - mắc kẹt
confuse - bối rối
avoid - tránh xa
tackle - giải quyết
separate - chia ra
rugby - bóng bầu dục
particular - cụ thể
pressure - áp lực
compulsory - bắt buộc
cognitive - nhận thức
perspectives - quan điểm
marure - trưởng thành
weird - kỳ quặc
maturity - sự trưởng thành
a lack of - sự thiếu hụt
minimal - tối thiểu
mystery - bí ẩn
bible - Kinh thánh
compensate - đền bù
bowel movement - đi tiêu
urine - nước tiểu
surround - bao quanh
essentially - Thiết yếu
equivalent - tương đương
nourish - nuôi
composition - thành phần
even wetter - thậm chí còn ướt hơn
factor - nhân tố
depending - tùy thuộc
breakthrough - đột phá
sausage - xúc xích
trail - đường mòn
road - đường
combine - kết hợp
raise - nâng lên
crucial - chủ yếu
fluently - trôi chảy
pride - kiêu hãnh
ambition - tham vọng
candidate - ứng viên
deprecated - đã lỗi thời
